XXXXXXXXXXXXXXXXXXXXXXXXXXXXXXXXXXXXXXXX
XE________o___X_______X_____o__________X
X_XXXXX_XXX_X_XXX_XXX_XX__X_XXXXX_XXXX_X
X_____X_____X___X___X___X_X_____X______X
XXXX_XX_XXXXX_XX_XX_XX_XX_X_XXX_XXXXXXXX
X_o_____o___X___X___o___X_X___o________X
X_X_XXXXX_X_X_XXX_XXXXX_X_X_XXXXX__XXXXX
X___X___X___X___X___X___X_X___X___X____X
XXX_X_o_X_XXX_X_o_X_XXX_X_XXX_X_o_X_XXXX
X_______X___X_______X___X___X_______X__X
X_XXXXXXX_X_X_XXXXX_X_X_X_X_XXXXXXX_X_XX
X_________o_X___o___X___X_X_________o__X
X_XXXXX_XXX_X_XXX_XXX_XXX_X_XXXXX_XXX_XX
X___o___X_______X_______X___X___o___X__X
X_XXXXX_X_XXXXX_X_XXXXX_X_XXX_XXXXX_X_XX
X_______X_______X_______X_______o______X
X_XXXXXXXXXXXXX_XXXXXXXXXXXXX_XXXXXXXXXX
X_o___________X_______________X________X
XXXXXXXXXX_XXXXXXXXXXXXXXXXXXXX_XXXXXXXX
X_______________S______________________X
XXXXXXXXXXXXXXXXXXXXXXXXXXXXXXXXXXXXXXXX